...###.....
..##.#.####
.##..###...
##.........
#..#@#.#...
########...
..#..#....#
.##.##.#.##
.#......##
.#.....##
.#######

